1
 #######B#
 ####### #
    #### #
### ###  #
    ### ##
###     ##
### ### ##
### ###  #
### #### #
A   #### #
##########

2
 #######C#
 ####### #
    #### #
### ###  #
    ### ##
###     ##
### ### ##
### ###  #
### #### #
A   #### #
##########

3
 #######B#
 ####### #
    #### #
### ###  #
    ### ##
###     ##
### ### ##
### ###  #
### #### #
A   #### #
##########